000000004000000-
000000012100000-
000000012100000-
011111112100000-
012222222100000-
012111111111110-
012222222222223-
011111111111110-
000000000000000