0000000000000110000000000000-
0000000000000110000000000000-
0000000000000110000000000000-
0011111111111110000000000000-
0011111111111110000000000000-
0011000000000000000000000000-
0011000000000000000000000000-
0011111111111111111111111100-
0011111111111111111111111100-
0000000000000000000000001100-
0000000000000000000000001100-
1111111111111111111111111100-
1111111111111111111111111100-
0000000000000000000000000000-
0000000000000000000000000000-
0000000000000000000000000000