000000001000000-
000000001000000-
000000001000000-
000000001000000-
001111111000000-
001000000000000-
001111111111111-
000000000000000-
000000000000000